111111111111111111111111111111
100000000000000000010000001011
10000000000000000000011111C111
1P0000000000000000001100000001
1000000000000000000010C0000001
1000000000000000000010C0000001
1000000000000000000010C0000001
1000000000000000000010C0000001
1000000000000000000010C0000001
1000000000000000000010C0000001
1000000000000000000010C0000001
1000000000000000000000C0000001
1000000000000000000001E0000001
101111111111111111101CM0001101
111111111111111111111111111111