11111111111111
10010000000C11
10000111110011
1P0011E0000001
10001000000001
10100000001101
11111111111111