111111111111111111111111111111
100000000000000000010000001011
10000000000000000000011111C111
100000000000000000001100000001
1000000000000000000010C0000001
10000P0000000000000010C0000001
1000000M00000000000010C0000001
1000000000000000000010C0000001
1000000000000000000010C0000001
1000000000000000000010C0000001
1000000000000000000010C0000001
1000000000000000000000M0000001
100000000000M00000000MEM000001
101111111111111111100M00001101
111111111111111111111111111111