11111111111111
10010000000C11
10000111110011
100011E0000001
1000100000C001
1010C0000011P1
11111111111111