11111111111111
10MC00E00000P1
11111111111111